αrəm	arm
αt	at
fαnαχt	fanacht
kαpəL	capall
mαk	mac
mαLαχt	mallacht
tαχtuw	tachtadh
tαrt	tart
tαruw	tarbh
αχ	each
αlə	eala
αŋ	eang
αŋαχ	eangach
d′r′αm	dream
d′αrəg	dearg
f′αr	fear
g′αl	geal
k′αχtər	ceachtar
L′αnuw	leanbh
N′αd	nead
p′αkuw	peacadh	peaca
ʃαsuw	seasamh
t′αχ	teach
αsəl	asal
αspəl	aspal
αsrïgər	aisfhreagar
αnəN	ionann
kũαnəN	comhionann
kαhuw	caitheamh
mα	maith
gə	go
L′ɔ:r	leor
mαiç	maith
αhəNtəs	aitheantas
αhəNtə	aitheanta
#en̥′ə	aithne??
dαhin′	d’aithin
αhəNtə	aitheanta
mαhũw	maitheamh
fαrəg′ə	farraige
fαrsiN′	fairsing
mαrst′ən	mairstean	maireachtáil
αm′ʃir′	aimsir
tαvʃə	taibhse
αf′r′əN	aifreann
Lαhir′	láthair
mαhær′	máthair
sNαhəd	snáthad	snáthaid
sNαhuw	snáthadh
sNαhəd	snáthad	snáthadh
sNα:ihəm	snáithim
nα:iç	shnáith
sNα:t′ə	snáite
αhəs	áthas
#αhαr	fhaghthar
αmə	ama
αm	am
ʃɔ	seo
tαhər	táthar
Nα̃:wid′	namhaid
Nα̃vd′ə	naimhde
αgəs	agus
αskəL	ascall	ascaill
bαrəb	borb
bαtæL′t′ə	batáilte
blαgəd′	blagaid
brαhαn	brachán
fαLæn′	folláin
fαχlə	fochlach	fachlach
fαruw	foradh	fara
fαskuw	foscadh
kαgnuw	cognadh	cogaint
kαL	coll
kαskərt′	coscairt
mαguw	magadh
sαp	sop
skαhuw	scoitheadh
spαrαn	sparán
spɔrαn	sparán
tαrəmαn	tormán
fɔskluw	foscladh	oscailt
g′αrαn	gearrán
skαhαn	scáthán
glu:rəkαn	glúracán	gliúragáin
m′αkən	carrot
m′αkαn	carrot
L′αhən	leathan
L′αhαn	leathan
g′aləwαn	gealbhan
g′αləwən	gealbhan
ruəkən	ruacan
mαkαNtə	macánta
spαdαNtə	spadánta
f′iαNtə	fiánta
α̃uwlaNtə	amhlánta
α̃uwlɔr′	amhlóir	abhlóir
f′iəstαlαχ	fiastalach
f′αdαli:	feadalaigh	feadaíl
f′αdαlαχ	feadalach	feadaíl
f′ɛk′αlαχ	feiceálach
fαdαlαχ	fadálach
ɔr̥αlαχə	othrálacha	ofrálacha
ɔr̥æl	othráil	ofráil
u:hαs	uathás	uafás
prα:kαs	prácás
rα:mαs	rámas	ramás	raiméis
d′r′əuwlαs	dreabhlas	drabhlás
d′r′əuwlαsαχ	dreabhlasach	drabhlásach
o̤rLαr	urlár
ti:dɔr′	tuíodóir
ti:dαrαχt	tuíodóracht	tuíodóireacht
spwæʃt′αrαχt	spaisteoireacht
N′ɛəLtαrαχt	néalladóireacht	néaladóireacht
ʃαnəmαNti:	seanmóntaí	seanmóirí
ʃαnəmɔr′	seanmóir
fwiN′ɔg	fuinneog
fwiN′αg	fuinneog
fwi:l′αg	faoileog	faoileán
kyN′αg	cuinneog
m′iəLtɔgy:	míoltógaí	míoltóga
αsɔgy:	easógaí	easóga
b′αχɔgy:	beachógaí	beacha
kï̃vαd	coimheád
k′ïn′αl	cineál
k′ïn′αLtə	cineálta
kïl′αn	coileán
kɔrN′αl	coirneál	coirnéal
kαir̥′αm′		caithréim
dïvαn	duibheán	duibhéan
b′αrαd	bearád	bairéad
b′αruw	bearradh
αLαχ	eallach
əmα:rαχ	amárach
g′αrαχ	gearach	geire
g′er′	geir
ïm′αχt	imeacht
rαplαχαn	raplachán	raipleachán
rαpləhu:tə	rapla húta	raiple húta
ʃeʃr′αχ	seisreach
t′αLαχ	teallach
ũ:hαχə
ũ:kαχə
ũi	uaimh
f′iαχ	fiach
f′iαχə	fiacha
f′iə	fia
f′iαχæl′	fiacháil
k′ɛαχt	céachta
p′r′ɛαχtə	préachta
uαχə	úthacha?
uw	úth
uαχt	uacht
uαχtə	uachta
fα	fá
α	ó
ɔ:	ó
mα	mo
mə	mo
d′α:n	deán
d′α:n′	deáin
grα:Nə	gránna
grα:k′ə	gráice
krα:n′	cráin
